11111111
101E0001
101000P1
10100001
10100111
10100101
10100101
10100101
10111101
10C00001
11111111