11111111111
1P000000001
10000C00001
100000000E1
11111111111
