11111111111111111111111111111111111
10CE0000000000000000000000000000001
10000000000000000000000000000000001
10000000000000000000000000000000001
10000000000000011111111100000000001
10000000000000000000000000000000001
10000000000000000000000000000000001
10001111111111111100000000000000001
10000000000000000000000000000000001
10000000000000000000000111111100001
100000000000000000P0000000000000001
10011111111000000000000000000000001
10000000000000000000000000000000001
10000000000000000000000000000000001
10000000000000111111111111110000001
10000000000000000000000000000000001
10000000000000000000000000000000001
10000001111111111110000000000000001
10000000000000000000000000000000001
10000000000000000000000000000000001
10000000000000000000000000000000001
11111111111111111111111111111111111
