111111111111111
100000000000001
101111111011101
10100000101E101
101111111011101
100110PCE000001
100110000000111
100000000001101
111111000111001
100E00000100001
111111111111111