1111111111111
10000000100E1
1011111011101
1000001000101
1000101110001
1000100011111
1111111010001
100P0000100C1
1111111111111
