111111111111111
100000000000001
101111111011101
10100000101E101
101111111011101
10011CPC0000001
10011CCCC000111
100000000001101
111111000111001
100000000100001
111111111111111