111111000110011
100000000000001
001111111011101
101000001010101
101111111011100
100110PCE000001
100110000000111
000000000001101
111111000111001
100000000100001
111001111111111
