111111111111111
100000000000001
101111111011101
101000001010101
101111111011101
100110P0E000001
100110000000111
100000000001101
111111000111001
100000000100001
111111111111111