111111111111111
1000P0000000001
101111111011101
101000001010101
101111111011101
100110PCE000001
100110000000111
1000P0000001101
111111000111001
10000000010P001
111111111111111
