111111111111111
1chayanne000001
1la111111011101
1fraude01010101
1=)111111011101
100110PCE000001
100110000000111
100000000001101
111111000111001
100000000100001
111111111111111
