1111111111111
1000000000001
10C00P000E001
1000000000001
1110000000111
10101111001C1
11111CC111111
1CCCCCCCCCCC1
1111111111111
