1111111111111
1000000000001
10000P000E001
1000000000001
1000000000001
1000000000001
1111111111111
1CCCCCCCCCCC1
1111111111111
