111111111111111
100000000000001
101111111011101
101CCCCC1010101
101111111011101
10011CPCE000001
10011CCCC000111
1000000000011C1
111111000111CC1
1000000001CCCC1
111111111111111