111111111111111
100000000000001
101111111011101
101000001010101
101111111011101
10011P000000001
1001100C0000111
1000000000E1101
111111000111001
100000000100001
111111111111111
