11111111111111
1P0000010001E1
100C0001010101
11111101010101
10000100010101
10000111110101
11000000110001
11111111111111
