11111
1P001
11101
1C1E1
11111
