111111111111
1P11111111E1
1CCCCCCCCCC1
1CCCCCCCCCC1
1CCCCCCCCCC1
1CCCCCCCCCC1
1CCCCCCCCCC1
1CCCCCCCCCC1
111111111111