11111111111111111111111111111111111
1P1000100010001000100010001000100C1
10101010101010101010101010101010101
10101010101010101010101010101010101
10101010101010101010101010101010101
10101010101010101010101010101010101
10101010101010101010101010101010101
10101010101010101010101010101010101
10101010101010101010101010101010101
10101010101010101010101010101010101
10101010101010101010101010101010101
10101010101010101010101010101010101
10101010101010101010101010101010101
10101010101010101010101010101010101
10101010101010101010101010101010101
10101010101010101010101010101010101
10101010101010101010101010101010101
10101010101010101010101010101010101
10101010101010101010101010101010101
10101010101010101010101010101010101
10101010101010101010101010101010101
10101010101010101010101010101010101
10101010101010101010101010101010101
10101010101010101010101010101010101
10101010101010101010101010101010101
10101010101010101010101010101010101
10101010101010101010101010101010101
10101010101010101010101010101010101
10101010101010101010101010101010101
10101010101010101010101010101010101
10101010101010101010101010101010101
10101010101010101010101010101010101
100010001000100010001000100010001E1
11111111111111111111111111111111111